************************************
**.............****..*****....*....*
**........**.........**..........*.*
**........**.....................*.*
**..***...**............**..***..*.*
**..***...**............**..***..*.*
**..............****....**..***..***
**.............****..*****....*....*
**........**.........**..........*.*
**........**.....................*.*
**..***...**............**..***..*.*
**..***...**............**..***..*.*
**..............****....**..***..***
************************************
