************************************************************
************************************************************
***.******....................................*******.******
***.***....*******.*****.......*********......*******....***
***.***....*******.********..***********......*******.******
***.***....*******.********..***************..*******.******
***.***....*******.********..***************..*******....***
***..........................**************...........******
***.********..*************..************************.******
***.********..*************.....*********************.******
***.********..................................*******....***
***.********..*****************..******..************.******
***.............***************..******..************.******
***........******......***....................*******.******
***.***....*******..****.......*********......*******....***
***.****..********.********..***********.......******.******
***.***......*****.********..***************..*******.******
***.**************.********..***************..*******....***
***..........................***************..........******
***.********..*************..************************.******
***.********...*************....*********************.******
***.********..................................*******....***
***.********....***************..******..************.******
***.............***************..******..************.******
************************************************************
************************************************************
